NO ./textures/bricksx64.png
SO ./textures/garden1x64.png
WE ./textures/mossy.png
EA ./textures/eagle.png
C 0,0,0
F 91,78,255





1111111111111111111111111111111111111111111111111111111111
1110000001001000000000110110000000000000000000000000000011111111
1110000001011000000000110110000000000100100001001000000000000001
1110000001001000000000110110000000000100100001001111110111111111
11100000010010000000001101111111000001001000010010001101
11100111110010011111111101100000000001001000010010000101
11100000000000000000001101100000000001001000000000000001
11100011111110000000001101100000111111001000010011111111
1110000001111000000000110110000000000100100001001
11100000011110000000001101100111110000000100100001
11100000011110000E0000000000000000000100100001001
1110000001111000000000110110001100000100100001001
11100000011110000000001101100000000000000100001011
1111111111111100000000011011111111100000000001001
11100000011111111111000110110000000000100100001001
1110000001111000000000000110000000000100100001001
1110000000000000000000110110000000000100100001001
1110000001111000000000110110000000000100100001001
1110000001111000000000110110000000000100100001001
1110000001111000000000110110000000000100100001001
1110000001111000000000110110000000000100100001001
1111111111111111111111111111111111111111111111111
