F 91,78,255
NO ./textures/txt_no.xpm
SO ./textures/txt_so.xpm
WE ./textures/txt_we.xpm
EA ./textures/txt_ea.xpm
EA ./textures/txt_ea.xpm

C 184,220,255


111111111111111111111111111111
100000000000000000000000000001
100000001000000000000000000001111111111111111111111111111111111111111111111111111111111111111111111111111111111111111111111111111111111111111111111111111111111111111111111111111111111111111111111111111111111111111111111111111111111111111111111111111111111111111
10000000000000000000000000000000000000000000000000000000000000000000000000000000000000000000000000000000000000000000000000000000000000000000000000000000000000000000000000000000000000000000000000000000000000000000N1
10000000000000000000000000000111111111111111111111111111111111111111111111111111111111111111111111111111111111111111111111111111111111111111111111111111111111111111111111111111111111111111111111111111111111111111111111111111111111111111111111111111
100000000000000000000000000001
100000000000000000000000000001
100000000000000000000000000001
100000001000000000000000000001
100000000000000000000000000001
100000001000000000000000000001
100000000000000000000000000001
100000001000000000000000000001
100000000000000000000000000001
100000001000000000000000000001
100000000000000000000000000001
100000001000000000000000000001
100000000000000000000000000001
111111111111111111111111111111