F 91,78,255

NO ./textures/bricksx64.png
SO                             ./textures/garden1x64.png

WE                    ./textures/mossy.png
C 0,0,0

EA ./textures/eagle.png


111111111111111111111111111111111111
1111W111111111111111000000000000001
11100001111111111111000111111111111
1000000000111111111100011111
10000000000000000000000111
1000000000000000000000001
1000000000000000000000001
1000000000000000000000001
1000000000000000000000001
1000000000000000000000001
1000000000000000000000001
1000000000000000000000001
1000000000000000000000001
1000000000000000000000001
1000000000000000000000001
1000000000000000000000001
1000000000000000000000001
1000000000000000000000001
1000000000000000000000001
1000000000000000000000001
1000000000000000000000001
1000000000111111111101111
111111111111        1