F 91,78,255
NO /Users/jroth/42cursus/Cub3D/textures/bricksx64.png
S /Users/jroth/42cursus/Cub3D/textures/pillar.png
WE /Users/jroth/42cursus/Cub3D/textures/mossy.png
E /Users/jroth/42cursus/Cub3D/textures/purplestone.png

C 0,0,0
      11111111111111111111111111111111111111111111111111111111111111111111111111111111111111111111111111111111111
11111111100000000000000000000000000000000000000000000000000000000000000000000000000000000000000000000000000011111111
10100010000010001000001000100000100010000010001000001000100000100010000010001000001000100000100010000000000001
1000100000000010000000001000000000100000000010000000001000000000100000000010000000001000000000100000011111111
100000000000000000000000000000000000000000000000000000000000000000000000000000000000000000000000000001
100011111111111110000000111000000011100000001110000000111000000011100000001110000000111000000011100001
100011100000001110000000111000000011100000001110000000111000000011100000001110000000111000000011100001
110011100111111100000001110000000111000000011100000001110000000111000000011100000001110000000111000011111111111111111
  11   11      100000000000000000000000000000000000000000000000000000000000000000000000000000000000000000000000000001
110011100111111100000000000000000000000000000000000000000000000000W00000000000000000000000000000000001111111111111111
100000000000000000000000000000000000000000000000000000000000000000000000000000000000000000000000000001
111111111111100000000000000000000000000000000000000000000000000000000000000000000000000000000000000001
            111111111111111111111111111111111111111111111111111111111111111111111111111111111111111111