F 91,78,255
NO ./textures/bricksx64.png
SO                              ./textures/colorstone.png
WE                     ./textures/mossy.png

C 0,0,0
EA   ./textures/purplestone.png

                    1111111111111111
11111111111111111111000000000000001
1110S001111111111111000111111111111
100000000011111111110001
100000000000000000000001
1000000000000000000000001
1000000000111111111101111
111111111111        1