F 91,78,255
NO ./textures/txt_no.xpm
SO ./textures/txt_so.xpm
WE ./textures/txt_we.xpm
EA ./textures/txt_ea.xpm
EA ./textures/txt_ea.xpm

C 184,220,255

111111111111111111111111111111111111111111111111111111111111111111111111111111111111111111111111111111
100000000000000000000000000000000000000000000000000000000000000000000000000000000000000000000000000001
101000100000100010000010001000001000100000100010000010001000001000100000100010000010001000001000100001
100010000000001000000000100000000010000000001000000000100000000010000000001000000000100000000010000001
100000000000000000000000000000000000000000000000000000000000000000000000000000000000000000000000000001
100011111111111110000000111000000011100000001110000000111000000011100000001110000000111000000011100001
100011100000001110000000111000000011100000001110000000111000000011100000001110000000111000000011100001
100011100000001110000000111000000011100000001110000000111000000011100000001110000000111000000011100001
100000000000000000000000000000000000000000000000000000000000000000000000000000000000000000000000000001
100000000000000000000000000000000000000000000000000000000000000000W00000000000000000000000000000000001
100000000000000000000000000000000000000000000000000000000000000000000000000000000000000000000000000001
100000000000000000000000000000000000000000000000000000000000000000000000000000000000000000000000000001
111111111111111111111111111111111111111111111111111111111111111111111111111111111111111111111111111111