F 91,78,255
NO ./textures/txt_no.xpm
SO ./textures/txt_so.xpm
WE ./textures/txt_we.xpm
EA ./textures/txt_ea.xpm
C 184,220,255



111111111111111111111111111111
100000000000000000000000000001
100000000000000000000000000001
100000000000000000000000000001
100000000000000000000000000001
100000000000000N00000000000001
100000000000000000000000000001
100000000000111111111100000001
100000000000000000000000000001
111111111111111111111111111111