F 91,78,255
NO ./textures/txt_no.xpm
SO ./textures/txt_so.xpm
WE ./textures/txt_we.xpm
EA ./textures/txt_ea.xpm
EA ./textures/txt_ea.xpm

C 184,220,255


111111111111111111111111111111
100000000000000000000000000001
100000001000000000000000000001
100000000000000000000000000001
100000000000000000000000000001
100000000000000000000000000001
100000000000000000000000000001
100000000000000000000000000001
100000000000000000000000000001
10000000N000000000000000000001
100000001000000000000000000001
100000000000000000000000000001
100000001000000000000000000001
100000000000000000000000000001
100000001000000000000000000001
100000000000000000000000000001
100000001000000000000000000001
100000000000000000000000000001
111111111111111111111111111111