1.500000, 1.500000
x:1.500000 y:1.500000
player[1][1]
NO ./textures/txt_no.xpm
SO ./textures/txt_so.xpm
WE ./textures/txt_we.xpm

EA ./textures/txt_ea.xpm

F 255,0,255
C 0,255,0

111111111111111111111111111111
100000000000000000000000000001
100000000000000000000000000001
100000000000000000000000000001
100000000000000000000000000001
100000000000000000000000000001
100000000000000000000000000001
100000000000000000000000000001
100000000000000000000000000001
100000010100000100001000001001
111111110111111100001110111111
100000000000000100001110000001
101111111111110111111110000001
101000010000010000000000111111
101000010000011111111111100001
101000010000010000111000100001
101101111101110100111000011111
100000000000000100000000100001
111110111111110111111111101111
100010111111110100000100000001
100000000000000100000101111011
100011111111110110111101000001
111110000001010100000001000001
100000010101111101001000001001
111111111111111111111111111111
